{
  "levels": [
    {
      "map": [
        [0, 2, 1, 5, 1, 2, 0, 0, 0, 0],
        [0, 1, 0, 0, 0, 1, 0, 0, 0, 0],
        [0, 4, 0, 0, 0, 1, 0, 0, 0, 0],
        [0, 1, 8, 0, 0, 1, 1, 1, 1, 1],
        [0, 0, 0, 0, 0, 1, 0, 0, 0, 3],
        [0, 0, 0, 0, 0, 9, 0, 0, 0, 0]
      ]
    },
    {
      "map": [
        [0, 0, 0, 0, 0, 0, 0, 0, 0, 0],
        [0, 0, 0, 0, 1, 1, 0, 0, 0, 0],
        [1, 1, 2, 1, 7, 6, 1, 2, 0, 0],
        [1, 0, 0, 1, 0, 0, 0, 1, 0, 0],
        [3, 1, 1, 1, 0, 0, 0, 8, 0, 0],
        [9, 0, 0, 0, 0, 0, 0, 0, 0, 0]
      ]
    },
    {
      "map": [
        [2, 1, 4, 1, 2, 1, 4, 1, 2, 1],
        [1, 0, 0, 0, 0, 0, 0, 0, 0, 1],
        [5, 0, 1, 1, 1, 1, 1, 1, 0, 1],
        [1, 0, 2, 0, 0, 0, 0, 8, 0, 1],
        [3, 0, 1, 0, 0, 0, 0, 0, 0, 1],
        [9, 0, 4, 1, 2, 1, 4, 1, 2, 1]
      ]
    },
    {
      "map": [
        [1, 1, 1, 2, 1, 1, 2, 1, 1, 1],
        [7, 1, 1, 2, 1, 1, 2, 1, 1, 1],
        [1, 1, 1, 1, 1, 1, 1, 1, 1, 1],
        [1, 1, 1, 2, 1, 1, 2, 1, 1, 1],
        [1, 1, 1, 1, 2, 2, 1, 1, 1, 6],
        [9, 1, 1, 1, 1, 1, 1, 1, 6, 8]
      ]
    },
    {
      "map": [
        [0, 0, 0, 0, 0, 0, 0, 0, 0, 0],
        [0, 0, 0, 0, 0, 0, 0, 0, 0, 0],
        [0, 0, 0, 0, 0, 1, 1, 5, 1, 9],
        [0, 8, 1, 4, 1, 2, 1, 1, 1, 3],
        [0, 0, 0, 0, 0, 0, 0, 0, 0, 0],
        [0, 0, 0, 0, 0, 0, 0, 0, 0, 0]
      ]
    }
  ]
}
